Level 1
0000000000000
0000000000000
0000000000000
1111111111200
1111111111200
1111111111200
1111111111200
1111111111200
3333333333311
0000000000000
0000000000000
0000000000000
0000000000000
