0000000000000
1111120211111
1111120211111
1111120211111
1111120211111
1111120211111
0000000000000
1111120211111
1111120211111
1111120211111
1111120211111
1111120211111
2222220222222