0000000000000
1111110111111
1111110111111
1111110111111
1111110111111
1111110111111
0000000000000
1111120211111
1111120211111
1111120211111
1111120211111
1111120211111
1111120211111