Level 3
0000000000000
0000000100000
0020001110000
0020011111000
0020111311100
0020011111000
0020001110000
0020000100000
0020000000000
0022222222222
0000000000000
0000000000000
0000000000000
