Level 2
0000000000000
0000000000000
0000000000000
0001000001000
0000100010000
0001111111000
0011211121100
0111111111110
0101111111010
0102000002010
0000220220000
0000000000000
0000000000000
